###############################
#.............................#
#.............................#
#.............................#
#.............................#
#.............................G
#.............................#
#.............................#
###############################