66666666666666666666666666666666666666666666666666666666
66666666666666666666666666666666666666666666666666666666
66666666622222222226666266666226666666666666666666666666
66666222222222222222662226622222666622666666666666666666
66662222222222222222662222222222226222266666666666666666
66662222222222222226662212222221232232226666666666666666
66622221332112222133662131322211223222266666666666626666
66622211312211122112663331232111232332666666666266662666
66222232111133212123663323131211221222266666666226622666
62222233322123321333662222333231111223226666622222222666
62222223333112222233662222122321812222344444442122226666
62222222222212222223666221612331111122244444442112266666
62222266622212262222662226622321122663236666622113666666
62222666662122666226666226662111116662336666622212266666
66666666621126666666566111666666666666666666666213226666
66666666221266666666651555166666666666666666662231322666
66666662212266666666225552366666666666666666622112332666
66226622122666666622244854522666666666666666624222226666
66226222126666666663325553226666666666666666664666666666
62222321132266666623255525322266666266666666644666666666
66222213111226666626685811162666666222666666646666666666
66622221312226666666668666666666666222222226144666666666
66666232132322266666666666626666666662222224416666666666
66662221211132666666666666662666666623111214666666666666
66622232222212666666226226222664444411312132266666666666
66622222226622266662226266211264464411223322226666666666
66662222666624444444122662213224666212262322226666666666
66662666666266444444113266222324466222622226226666666666
66666666662266666662211444411113466226622266626666666666
66666666622266666666223266221111466666666666666666666666
66666666666266666662212266662232266666666666666666666666
66666266666666666666221226226623226666666666666666666666
66662226666666666622622266622262126666666666666666666666
66666626666666666626666666666666266666666666666666666666
66666666666666666666666666666666666666666666666666666666