###############################
#.............................#
G.............................#
#.............................#
#.............................#
#.............................#
#.............................#
#.............................#
###############################