555555555555555555577777777777775555555555
577777777777775555570000000000077777777775
571113330300075555570000000000077000000075
571@11133300077777770000000000077000000075
571111331030000000000000000000077000000075
573133133300000000000000000000077777007775
573330003000077777777007777770075557007555
577777777777775555557007555570075557007555
570000000000755555557007555570077777007775
570000000000755577777007555570000000000075
570000000000777770000007555570000000000075
570000000000000000000007555570077770077775
570000000000000000000077555577775570075555
570000000000777770000075555555555570075555
570000000000755577777775555555555570075555
577777777777755555555555555555555579975555