579975777777777755577557775557955555757775
570075700000000755000000005557055550000505
570077700000000755000005505550055500005005
570000000777700757000000007550555000005005
570000000770000757055500055550500050000007
570000000770000750005550005570005570000007
570000000770077750707500007577555550075507
577777777770075000707550077555557700755005
570000000000075005705550555557000005550077
570000000000075555700570055557050555550555
570000077777775557000550055555000557700777
550000075555555700075555055555055557000707
550000000000000000055570055500075557000007
570000000500005000555550000007575555500007
577557755575555775555555005755555555000707
555555555555555555555555555555555555555777