55555555555555155555555555555555555555555
55555555555551155555555555153511513355555
55555555555511115555555555155131331131555
90055555551113111155555553113115315313555
55001011551111131353555531131311513513555
55555550555133111331331315555555515553555
55555550555511113155551555555555115531555
55555551555511111115555555555555515553355
55551551555515111115555555555555135551355
55553153555551111111155555555553355533555
55515511355555551551515555555551555131555
55555511331144441551515555555555135355555
55555131355555551511555555555555331155555
55555555555555551555555555555555333555555
55555555555535311355555555555555445555555
55555555555553115555555555555555445555555
55555555555553135555533355555555445555555
55555555555511313555333335555555445555555
55555555555555553553331133555555445555555
55555555555555553553333144444444445555555
55555555555355555553113344444444445555555
55555555553535555553333335555555445555555
55544333443453555553333135555555445555555
55535555553433555555533355555555445555555
55535555555453555555555555555555445555555
55535555555455555555555555555555445555555
55535555555455555555555555555511445555555
55535555555455555555555555555133331155555
55535555535435555555555555551333133315555
55343555533444444444444444444333331315555
55383555553335555555555555551313333111555
55333555535555555555555555513337777333155
55555555555555555555555555577777997777755