5555555555555555555555555555555555555555555555555555
5555555555555555555555555555555555555555555555555555
5555555555555555555555555555555555555555555555555555
5555555555555555555555555555555555555555555555555555
5555555555555555555555555555555555555555555555555555
5555555555555555555555555555555555555555555555555555
5555555555555555555555555555555555555555555555555555
5555555555555555555555555555555555555555555555555555
5555555555555555555555555555555555555555555555555555
5555555555555555555555555555555555555555555555555555
5555555555555555555555555555555555555555555555555555
5555555555555555555555555777555555555555555555555555
5555555555555555555555777717777555555555555555555555
5555555555555555555577711111117775555555555555555555
5555555555555555555771111111111177555555555555555555
5555555555555555555717771111177717555555555555555555
5555555555555555557717571111175717755555555555555555
5555555555555555557117771111177711755555555555555555
5555555555555555557111111111111111755555555555555555
5555555555555555577111111111111111775555555555555555
5555555555555555571111111111111111175555555555555555
5555555555555555577111111111111111775555555555555555
5555555555555555557111111111111111755555555555555555
5555555555555555557117771111177711755555555555555555
5555555555555555557717571111175717755555555555555555
5555555555555555555717771111177717555555555555555555
5555555555555555555771111111111177555555555555555555
5555555555555555555577711111117775555555555555555555
5555555555555555555555777717777555555555555555555555
5555555555555555555555555777555555555555555555555555
5555555555555555555555555555555555555555555555555555
5555555555555555555555555555555555555555555555555555
5555555555555555555555555555555555555555555555555555
5555555555555555555555555555555555555555555555555555
5555555555555555555555555555555555555555555555555555
5555555555555555555555555555555555555555555555555555
5555555555555555555555555555555555555555555555555555
5555555555555555555555555555555555555555555555555555
5555555555555555555555555555555555555555555555555555
5555555555555555555555555555555555555555555555555555
5555555555555555555555555555555555555555555555555555